0000000000000000000000000000000000000000
0000000000000000000000000000000000000000
0000000000000000000000000000000000000000
0000000000000000000000000000000000000000
0000000000000000000000000000000000000000
0000000000000000000000000000000000000000
0000000000000000000000000000000000000000
0000000000000000000000000000000000000000
0000000000000000000000000000000000000000
0000000012222222222223000000000000000000
0000000045555555555556000000000000000000
0000000000000000000000000000000000000000
0000000000000000000000122230000122230000
0000000000000000000000455560000455560000
0000000000000000000000000000000000000000
0000000000000000000000000000000000000000
1222222222222222222222222222222230000000
4555555555555555555555555555555560000000
0000000000000000000000000000000000000000
0000000000000000000000000000000000000000
0000000000000000000000000000000001222223
0000000000000000000000000000000004555556