0000000000000000000000000000000000000000
0000000000000000000000000000000000000000
0000000000000000000000000000000000000000
0000000000000000000000000000000000000000
0000000000000000000000000000000000000000
0000000000000000000000000000000000000000
0000000000000000000000000000000000000000
0000000000000000000000000000000000000000
0000000000000000000000000000000000000000
0000000000000000000000000000000000000000
0000000000000000000000000000000000000000
0000000000000000000000000000000000000000
0000000000000000000000000000000000000000
0000000000000000000000000000000000000000
0012230000000000000000000000000000009000
0045560000000000000000000000000122222223
0000000000000000000000000000000455555556
0000000000000000000000000000000000000000
0000000000008000000000070000000000000000
1222222222222222222222222222230000000000
4555555555555555555555555555560000000000