0000000000000000000000000000000000000000
0000000000000000000000000000000000000000
0000000000000000000000000000000000000000
0000000000000000000000000000000000000000
0000000000000000000000000000000000000000
0000000000000000000000000000000000000000
0000000000000000000000000000000000000000
0000000000000000000000000000000000000000
0000000000000000000000000000000000000000
0000000000000000000000000000000000000000
0000000000000000000000000000000000000000
0000000000000000000000000000000000000000
0000000000000000000000000000000000000000
0000000000000000000000000000000000009000
0001230000000000000000000000000122222223
0004560000000000000000000000000555555556
0000000000000000000000000000000000000000
0000000000000000000000000000000000000000
0000000000008000000000070000000000000000
1222222222222222222222222222000000000000
4555555555555555555555555555000000000000
