0000000000000000000000000000000000000000
0000000000000000000000000000000000000000
0000000000000000000000000000000000000000
0000000000000000000000000000000000000000
0000007000000000000000000000000000000090
1222223000000000000000000000000000012223
4555556000000000000000000000000000045556
0000000000000000000000000000000000000000
0000000000000000000000000000001230000000
0000012300001222223000000000000000000000
0000000000004555556000123000000000000000
0000000000000000000000000000000012300000
1230000000000000000000000000000000000000
0000000000000000000000000000000000000000
0000000000000000000000000000000000000123
0080000000000000000000000000000000001223
0000000122300000000000000000000000004556
0000004556000000000000000000000000000000
1222223000000012230000000000001222230000
4555556000000045452300000000015555600000
0000000000000000000000012222300000000000