0000000000000000000000000000000000000000
0000000000000000000000000000000000000000
0000000000000000000000000000000000000000
0000000000001111000000000000000000000000
0000000000005555000000000000000000000000
0000000000000000000000000000000000000000
0000000000000000000000000011110000000000
0000000700000000000000000055550000000000
1111111100000000000008000000000000000000
5555555500000000000011110000000000000000
0000000000000000000055550000000000000000
0000000000000000000000000000000000000000
0000000000000000000000000000000000900000
0000000000000000000000000000000111100000
0000000000000000000000000000000555500000
0000000000000011110000000000000000000000
0000000000000055550000000000000000000000
0000111100000000000000000000000000000000
0000555500000000000000000000000000000000
1222000000000000000000000000000000000000
4555000000000000000000000000000000000000