0000000000000000000000000000000000000000
0000000000000000000000000000000000000000
0000000000000000000000000000000000000000
0000000000000000000000000000000000000000
0000007000000000000000000000000000000090
1222223000000000000000000000000000012223
4555556000000000000000000000000000045556
0000000000000000000000000000000000000000
0000000000000000000000000000001230000000
0000012300001222223000000000004560000000
0000045600004555556000123000000000000000
0000000000000000000000456000000012300000
0000000000000000000000000000000045600000
1230000000000000000000000000000000000000
4560000000000000000000000000000000000000
0080000000000000000000000000000000001223
0000000000000000000000000000000000004556
0000000000000000000000000000000000000000
1222222230000000000000000000000012222300
4555555560000012222300000000000155555600
0000000000000045555600012222300000000000