0000000000000000000000000000000000000000
0000000000000000000000000000000000000000
0000000000000000000000000000000000000000
0000000000001223000000000000000000000000
0000000000004556000000000000000000000000
0000000000000000000000000000000000000000
0000000000000000000000000012230000000000
0000000700000000000000000045560000000000
1222222300000000000008000000000000000000
4555555600000000000012230000000000000000
0000000000000000000045560000000000000000
0000000000000000000000000000000000000000
0000000000000000000000000000000000900000
0000000000000000000000000000000122300000
0000000000000000000000000000000455600000
0000000000000012230000000000000000000000
0000000000000045560000000000000000000000
0000122300000000000000000000000000000000
0000455600000000000000000000000000000000
1223000000000000000000000000000000000000
4556000000000000000000000000000000000000
