0000000000000000000000000000000000000000
0000000000000000000000000000000000000000
0000000000000012230000000000000000000000
0000000000000045560000000000000000000000
0000000000000000001223000000000000000000
0000000000000000000000000012230000000000
0000007000000000000000000045560000000000
1222222300000000000000004555600000000000
4555555600000000000000000004563000000000
0000000000000012222230000004555600000000
0000000000000045555560000004560000000000
0000000000000000000000000004560012300000
0000000000000000000000000004560000000000
0000000000000000000000000000000000000000
0000000000122300000000000000000000000123
0000000004556000000000000000000000012300
0800122300000001223000000000000000090000
0000455600000004556000000000001223000000
1223000000000000000000000004555556000000
4556000000000000000000122000000000000000
0000000000000000000000456000000000000000