0000000000000000000000000000000000000000
0000000000000000000000000000000000000000
0000000000000000000000000000000000000000
0000000000000000000000000000000000000000
0000000000000000000000000000000000000000
0000000000000000000000000000000000000000
0123000000000000000000000000000000012300
0456000000000000000000000000000000045600
0000000000000000000000000000000000000000
0000000000000000000000000000000000000000
12300lmmr0000000000123000000000000000000
4560000000000000000456000000000000000000
0000000000000000000000000000000000000000
0000000000000000000000000000000000000000
0123000000000lmmr00000000000001230000000
0456000000000000000000000000004560000000
0000000000000000000000000000000000000000
0000008000000000000000000000000000000000
0000000000007000090000000000000000000000
1222222222222222222222222222222222222223
4555555555555555555555555555555555555556
