0000000000000000000000000000000000000000
0000000000000000000000000000000000000000
0000000000000000000000000000000000000000
0000000000000000000000000000000000000000
0000000000000000000000000000000000008000
0000000000000000000000000000000000000000
012300000000lmmr000000000000000001222300
0456000000000000000000000000000004555600
0000000000000000000000000000000000000000
000000000000000000000000000rmml000000000
12300lmmr0000000001223000000000000000000
4560000000000000004556000000012300000000
0000000000000000000000000000045600000000
0000000000000000000000000000000000000000
0123000000000lmmr00000000000000000000000
0456000000000000000000000000000000000000
0000000000000000000000000123000000000000
0000000000000000000000000456000000000000
0000000000009000000000000000000000000007
0000000022222000012222000000000000122230
0000000055555000045556000000000000455560
